šerti		to feed an animal
maitinti		to feed a human
skydas		kalkan
tašė/umbrella term		el cantasi -kadinlar icin olan-
tarmė		dialect
smegenys		brain
puodelis kavos		one cup of a coffee
tardymas		interrogation
kantrus		patient
įkelti		to upload
plotas		a party at somebody's place
masofkė		a party with lots of people and commotion
tūsas		party with lots of dancing and loud music
pjanke		shitfaced drunk party
atmintis		hafiza
nuodingas		poisonious
lašinių		bacon
mano arkliukas		my speciality
melstis		to pray
janyčarai		yeniceriler
valiutos kursas		exchange rate
nugara		back
makiažas		makyaj
pajėgos		forces -like turkish/russian etc-
ilginti		to make smth longer
baimė		fear
lyginti		to compare
dulkės		toz
įtikinti		to convince
išprotejusi/ęs		crazy
perkelti		nakil
vadovės/lyderis		leaders
įprotis		habit
savininkas		homeowner
teisykla		kura
dubuo		kase/bowl
sparnai		kanatlar
ginkluotas		silah
įvaikinti		to adopt
teisė		law/right
lauktis		preggers
ištėkėti		to marry
auginti		to grow someone
auklėti		to raise smone
beviltiška		desperate
priekaištauti		sitem etmek
teigti 		to state somethng
karjera		kariyer
gimdyti		to give birth
priversta		forced
susidurti		to face with smth
brandas		mature
kita vertus		on the other hand
išgyventi		to survive
pomėgiai		hobbies
nuoširdis		sincerely
ko gero		probs
atrodyti		to seem
žvilgsnis		glance
interjero		interior
dizainerė		designer
vesti		to take someone to somewhere
korespondentė		muhabir
vadybininke		manager
iškart		iš karto
suteikti		to give
išlepinti		to spoil
baladė		ballad
našta ant pečių		burden on the shoulders
patenkinta		satisfied
pasidarė sunku		became difficult
juo		instrumental jis
smarkiai		strongly
nustatytų terminų		deadline
žingsnis		step
riba		limit
sauskelnės		diapers
ginti		to defend
prisitaikyti		to adapt
darbo rinka		labor market
gimstamumas		birth rate
nėštumas		pregnancy
parama		help as in material
motinystės pašalpa		maternity benefit
socialinis draudimas		social insurance
dvyniai		twins
skiriamas		being allocated
išmoka		odeme
kokiu atveju		what/which case
pritarti		to addagree
nesusituokę		unmarried
apsvarstyti		to consider
žymiai		significantly
vengti		to avoid
domėtis kuo		interested in
skliaustelis		parantez
sudėtinga		complicated
drovėtis		to be shy/ashamed
išsilavinimas		egitim -egitimim iyi gibi-
kai kurie		some
įvardis		pronoun
kišenė		pocket
rinkimai		elections
pagalvė		pillow
proga		occasion
vėlionis		dead person
svetima		someone else's
anyta		kaynana
našlaitis		yetim
našlys		widower
pamotė		uvey anne
darni		uyumlu
krikštynos		baptism
šeimos galva		kažkas užsidirbt pinigų šeimoj
šeiminė padėtis		medeni hal
užsidirbt pinigų		to make/earn money
sutuoktinis		spouse
įvaria		various
prižiūreti		to look after-to supervise
vienišai		alone adverb
kalbos žinias		language knowledge
be galo		endlessly
aukle		babysitter
įstoti		to enter
puse etato		part time
prarasti		to lose
komandiruotes		business trips
niekaip		no way
samdyti		to hire
